0a0e0c0c110c0c0f0f0f0f0f1000000b
0c0a0e0f0f0f1025000026250000000b
0c0c0a0129262700000024000000300b
0f0f102626262500000000002f01010b
0a12132726252226230000000203090c
0d141526262926250000000000000e0c
0c09030304262600000000000022260b
0c10272626250000000000000026270b
0d00002426000000002226222626260b
1000000026280000002629262602090c
000000222626272e2226262627260b0c
00000026272626080a26000024260b0c
000022080a26240e1025002a2a2a0b0c
0909090c0d2500080a2a2a0809090c0c
0c110c0c0d2a2a0b0c09090c0c0c110c
0c0c0c0c0c09090c0c0c0c0c0c0c0c0c