14150e0e0e0e0e0e15150e0e0e0b0000
0e0b0000000000000c0b310000000000
00000000000030000731000000050000
00000000003205000000000000060000
00000000003206000000000000060000
000000000032060000000000000600xE
000000000032063030303030300c0f0f
0000000002030e0303030303030e0e14
00000000002f2d2d2d2d000000xW000c
000000000000282d2e2d2d2a0500000c
303030303000002d2900292d0c0f0f15
0f0f0f0f09303001310000280a0e1515
0e0e0e0e0e0304330000000000000a15
27xP360000282d00000000000000000c
0f0f0927002f2d27000000000000000a
15150d2d262d2e2d0000000000000000