0000000000000000320100000a0e0e15
00000000000000303001000000282d0c
00000000000032020304xE0000002f0a
00000000000000003202030427000033
3000000000000000000000012f2d0030
052726000000000000000033282d2708
072d2e273000000000000030262d2d0a
0000282d05300000000000052d2d2e33
3000262d0705000000000007282d2930
052d2d29330627000000003300282d08
072d2f0030062d2600000030002d2d0a
33282d2e05062d2f27000005262d2933
00002d2d070629002d2e00072d2e0030
0000290033060000282d00002d2d0008
xP0000002607xC00002d27002d29000a
090000002e27000000282d2f2d000033