1515151515151515151515150d00xE0c
0e0e0e0e0e0e0e0e0e0e0e150d00000a
00000000000000000000000c0d000000
00000030000000000030000a0b000000
00003201310000003201310030000000
00000033000000000033003201313000
00000000000030000000300033320100
000000000032010000000531xC003300
00300000000033000000073100000000
32013130000000300000330000000000
00333201310032053100000000000000
xP000033000032063100000000000000
09000000000032073100000000000000
0d000000000000330000000000000000
0d000000000000300000000000000000
0d000005000032053100000000000000