090a15151415150e0e0e0e0e0b23220c
15090a0e0e0e0b2900002d2900001c0c
151509012f2d2e000000280000xE360c
0e0e0b2d2d2d2900000000003501010c
09xW262e2d29262d2700000002030f15
0d2d2d2d2d2f2d290000000000000a15
15090303042d2d000000000000262d0c
150b2e2d2d29000000000000002d2e0c
0d0000282d00000000262d262d2d2d0c
0b0000002d2a2b00002d2f2d2d020f15
000000262d2d2e34262d2d2d2e2d0c15
0000002d2e2d2d08092d0000282d0c15
00xP2608092d280a0b29003030300c15
0f0f0f150d290008093030080f0f1515
151415150d30300c150f0f1515151415
15151515150f0f151515151515151515