0e0b0000000c0e0e0e0b0a0e0e0e1515
2d2f000000072d2900000000002d0a14
2e2d273400262d0000000000002d000c
282d2d020304290000000000002d270c
002f2d2d2d29000000003030262d2d0a
282d2d2900000000000008092d2e2d29
002800000000303000000c0d2f2d2900
000000000000020400260c0d2d2d0000
000000000000012e2d2d0a1509000000
000000000000052d2d282d0a0b270000
0000xC000000072d000000282d2d2700
xP00350000000129000000002e2d0000
030303040000010000000036282d2700
282d0127002601000026000203030303
002e012d272d0500xC2d2a2c012d2d2d
0028012d2f2d0600262d2d2d012d2d2d