14150e0e0e0e0e0e15150e0e0e0b0000
0e0b0000000000000c0b310000000000
00000000000030000731000000050000
00000000003205000000000000060000
00000000003206000000000000060000
00000000003206000000000000063400
000000000032063030303030300c0f0f
0000000002030e030303030303151514
00000000002f2d2d2d2d0000000c1515
000000000000282d2e2d2d2a08151515
303030303000002d2900292d0c151415
0f0f0f0f09303001310000280a0e1515
0e0e0e0e0e0304330000000000000a15
27xP360000282d00000000000000000c
0f0f0927002f2d27000000000000000a
15150d2d262d2e2d0000000000000000