0e0e0e0e0e150d2d2d00000000000000
29xP00262d0c0d2e2900000000000000
030303042d0c0d2d0000000000000000
2d2d2e2d2d0c150f0900000000000000
2e2d292f290c14150d00000000000000
2d290000000c15150d00000000000000
2d303030300c15140d00000000000000
2d020303030e0e150d00003000000000
293333333333320c0d00320131000000
000000000000320c0dxC320131000000
000000000000320c0d30320131000000
303030300000300c0101010131000000
0f0f0304000001010101013100000000
150dxW00000000000000000000000000
0e0b0000000000000000000000000000
1818181818190000000000001d1e1e1f