150d0c15150d0a0e0e0e0c0d2d2d2d0c
150d0a0e0e0b2d2d002d0c0d282f2d0c
151509012f2d2929002d0c0d00262e0c
14150d2d2d29000000280c0b0000280c
15140d2900000000000006000000000c
150e0b0000000000000007000000340c
0d003600262700050000000000000815
150901012f29000627000000002b0c14
15150f092d2700072d2b27002c2d0a0e
1515140d2d2d2a012d2d2d2e2d2d080f
1415150d00282d052900282d2d020e15
0e0e150d00262d0600000000282d2d0c
002d0a0d262e2906000000000000280a
00282e072d290006303030000000262d
00xP282d2d2a350c0f0f090000002e2d
0f0f0f0f0f0f0f1515140d2a2b2c2d2d