14150e0e0e0e0e0e15150e0e0e0b2325
0e0b2d2a0000002d0c0b31282d2f2d2e
2d2d2e2900003028073100262d052900
2d2f280000320500290000002e060000
2d29000000320600000000262d060000
2e00000000320600000000002806xE00
2d272b2c2732063030303030300c0f0f
2d2d2e2d02030e0303030303030e0e14
29002800002f2d2d2d2d000000xW000c
000000000000282d2e2d2d2a0500000c
303030303000002d2900292d0c0f0f15
0f0f0f0f09303001310000280a0e1515
0e0e0e0e0e0304330000000033330a15
27xP360000282d000000000000002d0c
0f0f0927002f2d270000000000262f0a
15150d2d262d2e2d00000000002e2d2d