111111
100001
10C001
100001
1P00E1
111111