11111111
101000C1
11000101
10001101
1P1CE001
11111111