111111111111111111111
100000000001000000001
100000000000000000001
100000000000000000001
100000000000000000001
100000000000000000001
100000000000000000001
100000000000000000001
10000000C000000000001
100P0000000100000CE01
111111111111111111111