00000000000000000000000000000000
00000000000000000000000000000000
00000000000000000000000000000000
00000000000000000000000000000000
000000000000000000000000000000xC
00000000000000000000000000000001
00000000000000000000000000000001
00000000000000000000000000000001
0000000000000000000000000000xE01
00000000000000000000000000000101
00000000000000000000000000000101
xP000000000000000000000000000101
01010000000000000000000000000101
01010000000000000000000000000101
01010101010101000000000000000101
01010101010101010100000000000101